NO ./textures/north.xpm
WE ./textures/west.xpm
EA ./textures/east.xpm
SO ./textures/south.xpm

F 0,255,255
C 255,255,0

11111111111111111111
1E000000000000000001
11011111111111111111
1111
